000000000000000000000000
000000000000000000000000
000000000011111000000000
000000000100000100000000
000000000010101000000000
000000000001010000000000
000000000010301000000000
000000000001010000000000
000000000010101000000000
000000000100000100000000
000000000011111000000000
000000000000000000000000
000000000000000000000000
