000000000000000000000000
000000000011110000000000
000000000100001000000000
000000001000100100000000
000011110111311011110000
000100000000100000001000
000101110010000011101000
000010011111111110010000
000000001000010000000000
000000000000000000000000
000000000000000000000000
000000000000000000000000
000000000000000000000000
