000000000000000000000000
000000111000001110000000
000000100100010010000000
000100100010100010110000
001101000001000001010000
003100101103011010310000
001000101011101010011000
001001101000001011000000
000100101000001010000000
000010010000000100000000
000001100000000000000000
000000000000000000000000
000000000000000000000000
