000010000000000000000000
011110000001110000000000
010000000000100000000000
010000000000000000000000
011001000110000000000000
010010100100100000000000
010100010310110000000000
010133310010100000000000
010100010010100000000000
110110011100310000000000
000000000000000000000000
000000000000000000000000
000000000000000000000000
