00000000000000000000
00000110000000000000
00001001000000000000
00000110000000000000
00000000000000000000
00000000000110000000
00000000000100000000
00000000000000000000
00000110000000000000
00000101000000000000
00000010000000000000
00000000000000000000
00000000000000000000
00000000000000000000
